title: close_mine_real_world_1_20230719-164920
al: 1
kap: -18
bet: 2
dt: 1
werrcovmult: 0.1
mrpcov: 1e-12
scaled_UT: False
mtmscale: 1.0
SR: True
ctrl cov est: None
covest0: [2.115e-08 2.115e-08 2.115e-08 7.615e-05 7.615e-05 7.615e-05 2.500e+01
 2.500e+01 2.500e+01 1.000e-18 1.000e-18 1.000e-18 9.402e-09 9.402e-09
 9.402e-09 9.000e-04 9.000e-04 9.000e-04 1.000e+00 1.000e+00 1.000e+00]
intcov: [[1.e-17 0.e+00 0.e+00 0.e+00 0.e+00 0.e+00 0.e+00 0.e+00 0.e+00 0.e+00
  0.e+00 0.e+00 0.e+00 0.e+00 0.e+00 0.e+00 0.e+00 0.e+00 0.e+00 0.e+00
  0.e+00]
 [0.e+00 1.e-17 0.e+00 0.e+00 0.e+00 0.e+00 0.e+00 0.e+00 0.e+00 0.e+00
  0.e+00 0.e+00 0.e+00 0.e+00 0.e+00 0.e+00 0.e+00 0.e+00 0.e+00 0.e+00
  0.e+00]
 [0.e+00 0.e+00 1.e-17 0.e+00 0.e+00 0.e+00 0.e+00 0.e+00 0.e+00 0.e+00
  0.e+00 0.e+00 0.e+00 0.e+00 0.e+00 0.e+00 0.e+00 0.e+00 0.e+00 0.e+00
  0.e+00]
 [0.e+00 0.e+00 0.e+00 1.e-12 0.e+00 0.e+00 0.e+00 0.e+00 0.e+00 0.e+00
  0.e+00 0.e+00 0.e+00 0.e+00 0.e+00 0.e+00 0.e+00 0.e+00 0.e+00 0.e+00
  0.e+00]
 [0.e+00 0.e+00 0.e+00 0.e+00 1.e-12 0.e+00 0.e+00 0.e+00 0.e+00 0.e+00
  0.e+00 0.e+00 0.e+00 0.e+00 0.e+00 0.e+00 0.e+00 0.e+00 0.e+00 0.e+00
  0.e+00]
 [0.e+00 0.e+00 0.e+00 0.e+00 0.e+00 1.e-12 0.e+00 0.e+00 0.e+00 0.e+00
  0.e+00 0.e+00 0.e+00 0.e+00 0.e+00 0.e+00 0.e+00 0.e+00 0.e+00 0.e+00
  0.e+00]
 [0.e+00 0.e+00 0.e+00 0.e+00 0.e+00 0.e+00 1.e-12 0.e+00 0.e+00 0.e+00
  0.e+00 0.e+00 0.e+00 0.e+00 0.e+00 0.e+00 0.e+00 0.e+00 0.e+00 0.e+00
  0.e+00]
 [0.e+00 0.e+00 0.e+00 0.e+00 0.e+00 0.e+00 0.e+00 1.e-12 0.e+00 0.e+00
  0.e+00 0.e+00 0.e+00 0.e+00 0.e+00 0.e+00 0.e+00 0.e+00 0.e+00 0.e+00
  0.e+00]
 [0.e+00 0.e+00 0.e+00 0.e+00 0.e+00 0.e+00 0.e+00 0.e+00 1.e-12 0.e+00
  0.e+00 0.e+00 0.e+00 0.e+00 0.e+00 0.e+00 0.e+00 0.e+00 0.e+00 0.e+00
  0.e+00]
 [0.e+00 0.e+00 0.e+00 0.e+00 0.e+00 0.e+00 0.e+00 0.e+00 0.e+00 1.e-18
  0.e+00 0.e+00 0.e+00 0.e+00 0.e+00 0.e+00 0.e+00 0.e+00 0.e+00 0.e+00
  0.e+00]
 [0.e+00 0.e+00 0.e+00 0.e+00 0.e+00 0.e+00 0.e+00 0.e+00 0.e+00 0.e+00
  1.e-18 0.e+00 0.e+00 0.e+00 0.e+00 0.e+00 0.e+00 0.e+00 0.e+00 0.e+00
  0.e+00]
 [0.e+00 0.e+00 0.e+00 0.e+00 0.e+00 0.e+00 0.e+00 0.e+00 0.e+00 0.e+00
  0.e+00 1.e-18 0.e+00 0.e+00 0.e+00 0.e+00 0.e+00 0.e+00 0.e+00 0.e+00
  0.e+00]
 [0.e+00 0.e+00 0.e+00 0.e+00 0.e+00 0.e+00 0.e+00 0.e+00 0.e+00 0.e+00
  0.e+00 0.e+00 1.e-19 0.e+00 0.e+00 0.e+00 0.e+00 0.e+00 0.e+00 0.e+00
  0.e+00]
 [0.e+00 0.e+00 0.e+00 0.e+00 0.e+00 0.e+00 0.e+00 0.e+00 0.e+00 0.e+00
  0.e+00 0.e+00 0.e+00 1.e-19 0.e+00 0.e+00 0.e+00 0.e+00 0.e+00 0.e+00
  0.e+00]
 [0.e+00 0.e+00 0.e+00 0.e+00 0.e+00 0.e+00 0.e+00 0.e+00 0.e+00 0.e+00
  0.e+00 0.e+00 0.e+00 0.e+00 1.e-19 0.e+00 0.e+00 0.e+00 0.e+00 0.e+00
  0.e+00]
 [0.e+00 0.e+00 0.e+00 0.e+00 0.e+00 0.e+00 0.e+00 0.e+00 0.e+00 0.e+00
  0.e+00 0.e+00 0.e+00 0.e+00 0.e+00 9.e-12 0.e+00 0.e+00 0.e+00 0.e+00
  0.e+00]
 [0.e+00 0.e+00 0.e+00 0.e+00 0.e+00 0.e+00 0.e+00 0.e+00 0.e+00 0.e+00
  0.e+00 0.e+00 0.e+00 0.e+00 0.e+00 0.e+00 9.e-12 0.e+00 0.e+00 0.e+00
  0.e+00]
 [0.e+00 0.e+00 0.e+00 0.e+00 0.e+00 0.e+00 0.e+00 0.e+00 0.e+00 0.e+00
  0.e+00 0.e+00 0.e+00 0.e+00 0.e+00 0.e+00 0.e+00 9.e-12 0.e+00 0.e+00
  0.e+00]
 [0.e+00 0.e+00 0.e+00 0.e+00 0.e+00 0.e+00 0.e+00 0.e+00 0.e+00 0.e+00
  0.e+00 0.e+00 0.e+00 0.e+00 0.e+00 0.e+00 0.e+00 0.e+00 1.e-08 0.e+00
  0.e+00]
 [0.e+00 0.e+00 0.e+00 0.e+00 0.e+00 0.e+00 0.e+00 0.e+00 0.e+00 0.e+00
  0.e+00 0.e+00 0.e+00 0.e+00 0.e+00 0.e+00 0.e+00 0.e+00 0.e+00 1.e-08
  0.e+00]
 [0.e+00 0.e+00 0.e+00 0.e+00 0.e+00 0.e+00 0.e+00 0.e+00 0.e+00 0.e+00
  0.e+00 0.e+00 0.e+00 0.e+00 0.e+00 0.e+00 0.e+00 0.e+00 0.e+00 0.e+00
  1.e-08]]
conv time: (nan, nan, nan)
tc: nan
last 100 ang err mean: 0.002725627495038354
last 100 ang err max: 0.0030102572014865376
last 100 av err mean: 3.836235152141502e-06
last 100 av err max: 5.484150612140716e-06
