title: close_mine_real_world_10_20230719-120421
al: 1
kap: -18
bet: 2
dt: 10
werrcovmult: 0.1
mrpcov: 1e-12
scaled_UT: False
mtmscale: 1.0
SR: True
ctrl cov est: None
covest0: [2.115e-08 2.115e-08 2.115e-08 7.615e-05 7.615e-05 7.615e-05 2.500e+01
 2.500e+01 2.500e+01 1.000e-18 1.000e-18 1.000e-18 9.402e-09 9.402e-09
 9.402e-09 9.000e-04 9.000e-04 9.000e-04 1.000e+00 1.000e+00 1.000e+00]
intcov: [[1.e-16 0.e+00 0.e+00 0.e+00 0.e+00 0.e+00 0.e+00 0.e+00 0.e+00 0.e+00
  0.e+00 0.e+00 0.e+00 0.e+00 0.e+00 0.e+00 0.e+00 0.e+00 0.e+00 0.e+00
  0.e+00]
 [0.e+00 1.e-16 0.e+00 0.e+00 0.e+00 0.e+00 0.e+00 0.e+00 0.e+00 0.e+00
  0.e+00 0.e+00 0.e+00 0.e+00 0.e+00 0.e+00 0.e+00 0.e+00 0.e+00 0.e+00
  0.e+00]
 [0.e+00 0.e+00 1.e-16 0.e+00 0.e+00 0.e+00 0.e+00 0.e+00 0.e+00 0.e+00
  0.e+00 0.e+00 0.e+00 0.e+00 0.e+00 0.e+00 0.e+00 0.e+00 0.e+00 0.e+00
  0.e+00]
 [0.e+00 0.e+00 0.e+00 1.e-10 0.e+00 0.e+00 0.e+00 0.e+00 0.e+00 0.e+00
  0.e+00 0.e+00 0.e+00 0.e+00 0.e+00 0.e+00 0.e+00 0.e+00 0.e+00 0.e+00
  0.e+00]
 [0.e+00 0.e+00 0.e+00 0.e+00 1.e-10 0.e+00 0.e+00 0.e+00 0.e+00 0.e+00
  0.e+00 0.e+00 0.e+00 0.e+00 0.e+00 0.e+00 0.e+00 0.e+00 0.e+00 0.e+00
  0.e+00]
 [0.e+00 0.e+00 0.e+00 0.e+00 0.e+00 1.e-10 0.e+00 0.e+00 0.e+00 0.e+00
  0.e+00 0.e+00 0.e+00 0.e+00 0.e+00 0.e+00 0.e+00 0.e+00 0.e+00 0.e+00
  0.e+00]
 [0.e+00 0.e+00 0.e+00 0.e+00 0.e+00 0.e+00 1.e-11 0.e+00 0.e+00 0.e+00
  0.e+00 0.e+00 0.e+00 0.e+00 0.e+00 0.e+00 0.e+00 0.e+00 0.e+00 0.e+00
  0.e+00]
 [0.e+00 0.e+00 0.e+00 0.e+00 0.e+00 0.e+00 0.e+00 1.e-11 0.e+00 0.e+00
  0.e+00 0.e+00 0.e+00 0.e+00 0.e+00 0.e+00 0.e+00 0.e+00 0.e+00 0.e+00
  0.e+00]
 [0.e+00 0.e+00 0.e+00 0.e+00 0.e+00 0.e+00 0.e+00 0.e+00 1.e-11 0.e+00
  0.e+00 0.e+00 0.e+00 0.e+00 0.e+00 0.e+00 0.e+00 0.e+00 0.e+00 0.e+00
  0.e+00]
 [0.e+00 0.e+00 0.e+00 0.e+00 0.e+00 0.e+00 0.e+00 0.e+00 0.e+00 1.e-17
  0.e+00 0.e+00 0.e+00 0.e+00 0.e+00 0.e+00 0.e+00 0.e+00 0.e+00 0.e+00
  0.e+00]
 [0.e+00 0.e+00 0.e+00 0.e+00 0.e+00 0.e+00 0.e+00 0.e+00 0.e+00 0.e+00
  1.e-17 0.e+00 0.e+00 0.e+00 0.e+00 0.e+00 0.e+00 0.e+00 0.e+00 0.e+00
  0.e+00]
 [0.e+00 0.e+00 0.e+00 0.e+00 0.e+00 0.e+00 0.e+00 0.e+00 0.e+00 0.e+00
  0.e+00 1.e-17 0.e+00 0.e+00 0.e+00 0.e+00 0.e+00 0.e+00 0.e+00 0.e+00
  0.e+00]
 [0.e+00 0.e+00 0.e+00 0.e+00 0.e+00 0.e+00 0.e+00 0.e+00 0.e+00 0.e+00
  0.e+00 0.e+00 1.e-18 0.e+00 0.e+00 0.e+00 0.e+00 0.e+00 0.e+00 0.e+00
  0.e+00]
 [0.e+00 0.e+00 0.e+00 0.e+00 0.e+00 0.e+00 0.e+00 0.e+00 0.e+00 0.e+00
  0.e+00 0.e+00 0.e+00 1.e-18 0.e+00 0.e+00 0.e+00 0.e+00 0.e+00 0.e+00
  0.e+00]
 [0.e+00 0.e+00 0.e+00 0.e+00 0.e+00 0.e+00 0.e+00 0.e+00 0.e+00 0.e+00
  0.e+00 0.e+00 0.e+00 0.e+00 1.e-18 0.e+00 0.e+00 0.e+00 0.e+00 0.e+00
  0.e+00]
 [0.e+00 0.e+00 0.e+00 0.e+00 0.e+00 0.e+00 0.e+00 0.e+00 0.e+00 0.e+00
  0.e+00 0.e+00 0.e+00 0.e+00 0.e+00 9.e-11 0.e+00 0.e+00 0.e+00 0.e+00
  0.e+00]
 [0.e+00 0.e+00 0.e+00 0.e+00 0.e+00 0.e+00 0.e+00 0.e+00 0.e+00 0.e+00
  0.e+00 0.e+00 0.e+00 0.e+00 0.e+00 0.e+00 9.e-11 0.e+00 0.e+00 0.e+00
  0.e+00]
 [0.e+00 0.e+00 0.e+00 0.e+00 0.e+00 0.e+00 0.e+00 0.e+00 0.e+00 0.e+00
  0.e+00 0.e+00 0.e+00 0.e+00 0.e+00 0.e+00 0.e+00 9.e-11 0.e+00 0.e+00
  0.e+00]
 [0.e+00 0.e+00 0.e+00 0.e+00 0.e+00 0.e+00 0.e+00 0.e+00 0.e+00 0.e+00
  0.e+00 0.e+00 0.e+00 0.e+00 0.e+00 0.e+00 0.e+00 0.e+00 1.e-07 0.e+00
  0.e+00]
 [0.e+00 0.e+00 0.e+00 0.e+00 0.e+00 0.e+00 0.e+00 0.e+00 0.e+00 0.e+00
  0.e+00 0.e+00 0.e+00 0.e+00 0.e+00 0.e+00 0.e+00 0.e+00 0.e+00 1.e-07
  0.e+00]
 [0.e+00 0.e+00 0.e+00 0.e+00 0.e+00 0.e+00 0.e+00 0.e+00 0.e+00 0.e+00
  0.e+00 0.e+00 0.e+00 0.e+00 0.e+00 0.e+00 0.e+00 0.e+00 0.e+00 0.e+00
  1.e-07]]
conv time: (nan, nan, nan)
tc: nan
last 100 ang err mean: 0.013496976147570519
last 100 ang err max: 0.018226901656110513
last 100 av err mean: 5.178021019609859e-06
last 100 av err max: 9.330337814356572e-06
